111111111
1PEC01MM1
111111111
