111111111111111111111111111111111111111111111
1000000000000000000000P0000000000000000000001
100111111111110111111000111111011111111111001
100111111111110111111000111111011111111111001
10000000000C1101100000C0000011011C00000000001
100110011100110110000111000011011001110011001
100110011100110110001000100011011001110011001
100110011100110000000000000000011001110011001
10011C000000111111100010001111111000000C11001
1001111111001111111000C0001111111001111111001
1001111111000000C11000100011C0000001111111001
1000000C11001110011000C00011001110011C0000001
100111001100111001100010001100111001100111001
100111001100111001100000001100111001100111001
1001110011C00000011111111111000000C1100111001
100000001111111001111111111100111111100000001
100000001111111000000C1C000000111111100000001
100111000000C1100111001001110011C000000111001
100111001110011001110010011100110011100111001
100111001110011001110010011100110011100111001
1000C0000000011C0000001000000C1100000000C0001
1001111111100111111100E0011111110011111111001
100000CC00000000000000000000000000000CC000001
111111111111111111111111111111111111111111111
