111111111111111111111111111111111111111111111
10000000000C000000000C00000000000C00000000001
101111111111111111111011111111111111111111101
10100000000C00000000101C000000000C00000000101
101011111111111111101010111111111111111110101
10101000000C000000101010100000000C00000010101
101010111111111111101010101111111111111010101
1010101E000C000000001010101000000C00000010101
101010111111111111111010101011111111111110101
10101000000C000000000010101000000C00000000101
101011111111111111111110101111111111111111101
10100000000C000000000CCC100000000C00000000001
101111111111111111111CPC111111111111111111101
10000000000C000000001CCC000000000C00000000101
101111111111111111101011111111111111111110101
10100000000C00000010101C000000000C00000010101
101011111111111110101010111111111111111010101
10101000000C000000101010100000000C00001010101
101010111111111111101010101111111111111010101
10101000000C000000001010101000000C00000010101
101011111111111111111010101111111111111110101
10100000000C000000000C10100000000C00000000101
101111111111111111111110111111111111111111101
10000000000C00000000000C000000000C00000000001
111111111111111111111111111111111111111111111
