111111111111111111111111111111111111111111111
1C00000000000000000000P00000000000000000000C1
10M011110011110011111010111110011110011110M01
1000111100111100100000M0000010011110011110001
100011110011110010001101100010011110011110001
10000000C00000M0100011C1100010M00000C00000001
100000000C00000C1000110110001C00000C000000001
100011110011111110001101100011111110011110001
10001111001000000M000000000M00000010011110001
10001111001000C000011111110000C00010011110001
100011110010000000011111110000000010011110001
10C00000M0000111000000E0000001110000M00000C01
10C00000M0000111000000M0000001110000M00000C01
100011110010000000011111110000000010011110001
10001111001000C000011111110000C00010011110001
10001111001000000M000000000M00000010011110001
100011110011111110001101100011111110011110001
100000000C00000C1000110110001C00000C000000001
10000000C00000M0100011C1100010M00000C00000001
100011110011110010001101100010011110011110001
1000111100111100100000M0000010011110011110001
10M011110011110011111010111110011110011110M01
1C00000000000000000000000000000000000000000C1
111111111111111111111111111111111111111111111
