111111111111111111111111111111111111111111111
1000000000000000000000P0000000000000000000001
100111111111110111111000111111011111111111001
100111111111110111111000111111011111111111001
100000M0000C1101100000C0000011011C0000M000001
100110011100110110M0011100M011011001110011001
100110011100110110001000100011011001110011001
1001100111001100000000M0000000011001110011001
10011C0000M01111111000100011111110M0000C11001
1001111111001111111000C0001111111001111111001
10011111110M0000C11000100011C0000M01111111001
1000000C11001110011000C00011001110011C0000001
100111001100111001100010001100111001100111001
1001110011001110011000M0001100111001100111001
1001110011C0000M0111111111110M0000C1100111001
100M00001111111001111111111100111111100M00001
10000M0011111110M0000C1C0000M011111110000M001
1001110M0000C1100111001001110011C0000M0111001
100111001110011001110010011100110011100111001
100111001110011001110010011100110011100111001
1000C0000000011C0000M010M0000C1100000000C0001
1001111111100111111100E0011111110011111111001
100000CC00000000000000000000000000000CC000001
111111111111111111111111111111111111111111111
