11111111111111111111111
10101101010C01010110101
10C0010C0C101C0C0100C01
100010M0010E0100M010001
10010000100000100001001
10000C00001110000C000M1
1M000C00001110000C00001
10010000100000100001001
100010M0010P0100M010001
10C0010C0C101C0C0100C01
10101101010C01010110101
11111111111111111111111
